Café Valkiria Café – Porto Alegre	
Café The Public Market – Porto Alegre
Café Le Manjue – Vila Nova Conceição
Café e Confeitaria Marilia Zylbersztajn – Callebaut Chocolate Week
Café Octavio Café – Jardim Paulistano
Café King of the Fork – Pinheiros
Café Éclair Moi Paris
Maria Brigadeiro – Pinheiros
Café Addolcire – Moema
Café Bolo e Bule – Jardins – São Paulo
Lavazza Café do Eataly SP
Café Santa Monica
Café Casa Santa Luzia – Visita II
Café Coffee Lab – Vila Madalena
Havanna Café – Shopping Ibirapuera
Café Casa Santa Luzia
Café AMMA Chocolate – Visita II
Café Casa Bauducco – Shopping Morumbi
Café Renata Arassiro Chocolates Finos
Café AMMA Chocolate
Café Le Pain Quotidien – Vila Madalena
Café e Padaria – Santo Pão – Jardim Paulista
Café PÃO – Padaria Artesanal Orgânica
Café Pain Et Chocolat – Moema
Café Otávio Machado
Café Sofá Café – Shopping Cidade Jardim
Café Boutique Marie-Madeleine – Visita II
Café Nano – Cafés e Comidinhas Especiais
Café des Fleurs – Campo Belo
Café Confeitaria Martin Holandesa – Holambra – Visita II
Café Renata Arassiro Chocolates
Café Lá da Venda – Shopping JK
Café iDolci – Shopping JK Iguatemi
Café Doceria Folie
Café da Kopenhagen Alexandre Dumas
Café da Padaria Santa Marcelina
Chá The Gourmet Tea – Shopping Morumbi
Café Confeitaria Marilia Zylbersztajn
Café Brigaderia – Shopping Market Place
Café Boutique Marie-Madeleine
Café Confeitaria Martin Holandesa – Holambra
Café Coffee Express – Aeroporto João Pessoa
Café Le Pain Quotidien – Shopping Vila Olímpia